13,29,27,26,28,01,01,01,01,01,01,01,01,01,01,01,01,12,07,07,07,07,07,07,07
13,29,26,26,28,01,06,06,01,01,01,06,01,01,06,05,01,12,07,07,07,07,07,07,07
13,29,27,26,28,06,01,00,06,00,06,06,06,00,05,06,06,12,07,07,07,07,07,07,07
13,29,27,26,28,06,06,06,06,06,06,06,00,06,06,06,06,12,07,07,08,10,07,07,07
13,29,27,27,28,06,06,00,05,05,16,17,06,06,05,01,06,12,07,07,11,09,07,07,07
13,29,27,26,28,06,05,06,06,00,05,06,06,06,00,06,06,12,07,07,07,07,07,07,07
13,29,27,27,28,05,01,06,06,05,00,06,00,06,06,00,06,23,15,15,15,15,15,15,15
13,29,26,27,28,06,06,00,00,00,00,06,06,00,06,06,06,06,06,06,06,06,06,06,01
13,29,27,27,26,25,25,25,25,25,25,25,25,25,25,25,25,25,25,25,25,25,25,25,25
13,29,26,26,27,26,27,26,27,27,26,27,27,26,27,27,27,26,27,27,26,27,26,26,26
13,29,26,26,27,27,27,26,27,26,27,27,26,27,27,27,26,26,27,26,27,26,27,27,27
13,29,24,24,26,27,27,26,24,24,24,24,24,24,24,24,24,24,24,24,24,24,24,24,24
13,00,06,06,29,27,27,28,05,05,06,06,06,01,05,06,06,05,06,05,00,00,05,06,01
13,06,06,00,29,27,26,28,06,16,17,05,06,06,00,06,20,14,14,14,14,14,14,14,14
13,06,00,06,29,27,27,28,06,06,06,06,00,06,06,06,12,07,07,07,07,07,07,07,07
13,06,00,06,29,27,26,28,06,00,06,05,06,06,20,14,07,07,07,07,07,07,07,07,07
13,06,06,00,29,27,26,28,01,00,00,05,05,01,12,07,07,07,07,07,07,07,07,07,07
13,06,00,06,29,26,26,28,06,00,06,20,14,14,07,07,07,07,07,07,07,07,07,07,07
13,00,06,06,29,27,27,28,05,05,06,12,07,07,07,07,07,07,07,07,07,07,07,07,07
13,01,01,01,29,27,26,28,01,01,05,12,07,07,07,07,07,07,07,07,07,07,07,07,07

1,0,0,0,0,1,1,1,1,1,1,1,1,1,1,1,1,1,1,1,1,1,1,1,1
1,0,0,0,0,1,0,0,1,1,1,0,1,1,0,0,1,1,0,0,0,0,0,0,1
1,0,0,0,0,0,1,0,0,0,0,0,0,0,0,0,0,1,0,0,0,0,0,0,1
1,0,0,0,0,0,0,0,0,0,0,0,0,0,0,0,0,1,0,0,0,0,0,0,1
1,0,0,0,0,0,0,0,0,0,1,1,0,0,0,1,0,1,0,0,0,0,0,0,1
1,0,0,0,0,0,0,0,0,0,0,0,0,0,0,0,0,1,0,0,0,0,0,0,1
1,0,0,0,0,0,1,0,0,0,0,0,0,0,0,0,0,1,1,1,1,1,1,1,1
1,0,0,0,0,0,0,0,0,0,0,0,0,0,0,0,0,0,0,0,0,0,0,0,1
1,0,0,0,0,0,0,0,0,0,0,0,0,0,0,0,0,0,0,0,0,0,0,0,0
1,0,0,0,0,0,0,0,0,0,0,0,0,0,0,0,0,0,0,0,0,0,0,0,0
1,0,0,0,0,0,0,0,0,0,0,0,0,0,0,0,0,0,0,0,0,0,0,0,0
1,0,0,0,0,0,0,0,0,0,0,0,0,0,0,0,0,0,0,0,0,0,0,0,0
1,0,0,0,0,0,0,0,0,0,0,0,0,1,0,0,0,0,0,0,0,0,0,0,1
1,0,0,0,0,0,0,0,0,1,1,0,0,0,0,0,1,1,1,1,1,1,1,1,1
1,0,0,0,0,0,0,0,0,0,0,0,0,0,0,0,1,0,0,0,0,0,0,0,1
1,0,0,0,0,0,0,0,0,0,0,0,0,0,1,1,0,0,0,0,0,0,0,0,1
1,0,0,0,0,0,0,0,1,0,0,0,0,1,1,1,0,0,0,0,0,0,0,0,1
1,0,0,0,0,0,0,0,0,0,0,1,1,1,0,0,0,0,0,0,0,0,0,0,1
1,0,0,0,0,0,0,0,0,0,0,1,0,0,0,0,0,0,0,0,0,0,0,0,1
1,1,1,1,0,0,0,0,1,1,1,1,1,1,1,1,1,1,1,1,1,1,1,1,1