07,07,07,07,07,07,07,07,07,07,07,07,07,07,07,07,07,07,07,07,07,07,07,07,07
07,07,07,07,07,07,07,07,07,07,07,06,06,06,06,06,06,06,06,06,06,06,06,07,07
07,07,07,07,07,07,07,07,07,07,07,06,07,07,07,07,07,06,06,06,07,07,06,06,07
07,07,07,07,07,07,07,07,07,07,07,06,07,06,06,06,06,06,07,06,07,07,07,06,07
07,07,07,07,07,07,07,07,07,07,07,06,07,06,06,07,07,07,07,06,07,07,07,06,07
07,07,07,07,07,07,06,06,06,06,06,06,07,06,06,07,07,07,07,06,06,06,06,06,07
07,07,07,07,07,07,06,07,06,06,07,06,07,07,06,06,06,07,07,07,06,06,06,06,07
07,06,06,06,06,07,06,07,06,06,06,06,06,06,07,06,06,06,06,07,06,07,07,06,07
07,06,06,06,06,06,06,07,07,06,07,06,07,06,06,06,07,07,06,07,06,07,07,06,07
07,06,06,07,07,07,06,06,07,06,06,06,06,06,06,07,06,06,06,07,06,06,06,06,07
07,06,06,07,07,07,07,06,07,06,06,06,06,06,07,06,06,07,07,07,06,06,06,06,06
07,06,06,07,07,07,07,06,06,06,07,07,06,06,06,06,06,06,06,06,06,06,06,06,06
07,06,06,07,07,07,07,07,07,06,07,06,06,06,06,07,07,07,07,07,07,07,06,06,06
07,06,06,07,07,07,07,07,07,06,06,06,06,06,06,06,06,06,06,06,06,06,06,06,06
06,06,06,06,06,07,07,07,07,07,07,07,07,07,07,07,06,06,07,07,06,06,06,06,06
06,06,07,06,06,07,07,07,07,07,07,07,07,07,07,07,07,07,07,07,07,07,07,07,07
06,06,07,06,06,07,07,07,07,07,07,07,07,07,07,07,07,07,07,07,07,07,07,07,07
06,06,06,06,06,07,07,07,07,07,07,07,07,07,07,07,07,07,07,07,07,07,07,07,07
06,06,06,06,06,07,07,07,07,07,07,07,07,07,07,07,07,07,07,07,07,07,07,07,07
07,07,07,07,07,07,07,07,07,07,07,07,07,07,07,07,07,07,07,07,07,07,07,07,07

1,0,0,0,0,0,0,0,0,0,0,0,0,0,0,0,0,0,0,0,0,0,0,0,0
1,0,0,0,0,0,0,0,0,0,0,0,0,0,0,0,0,0,0,0,0,0,0,0,0
1,0,0,0,0,0,0,0,0,0,0,0,0,0,0,0,0,0,0,0,0,0,0,0,0
1,0,0,0,0,0,0,0,0,0,0,0,0,0,0,0,0,0,0,0,0,0,0,0,0
1,0,0,0,0,0,0,0,0,0,0,0,0,0,0,0,0,0,0,0,0,0,0,0,0
1,0,0,0,0,0,0,0,0,0,0,0,0,0,0,0,0,0,0,0,0,0,0,0,0
1,0,0,0,0,0,0,0,0,0,0,0,0,0,0,0,0,0,0,0,0,0,0,0,0
1,0,0,0,0,0,0,0,0,0,0,0,0,0,0,0,0,0,0,0,0,0,0,0,0
1,0,0,0,0,0,0,0,0,0,0,0,0,0,0,0,0,0,0,0,0,0,0,0,0
1,0,0,0,0,0,0,0,0,0,0,0,0,0,0,0,0,0,0,0,0,0,0,0,0
1,0,0,0,0,0,0,0,0,0,0,0,0,0,0,0,0,0,0,0,0,0,0,0,0
1,0,0,0,0,0,0,0,0,0,0,0,0,0,0,0,0,0,0,0,0,0,0,0,0
1,0,0,0,0,0,0,0,0,0,0,0,0,0,0,0,0,0,0,0,0,0,0,0,0
1,0,0,0,0,0,0,0,0,0,0,0,0,0,0,0,0,0,0,0,0,0,0,0,0
1,0,0,0,0,0,0,0,0,0,0,0,0,0,0,0,0,0,0,0,0,0,0,0,0
1,0,0,0,0,0,0,0,0,0,0,0,0,0,0,0,0,0,0,0,0,0,0,0,0
1,0,0,0,0,0,0,0,0,0,0,0,0,0,0,0,0,0,0,0,0,0,0,0,0
1,0,0,0,0,0,0,0,0,0,0,0,0,0,0,0,0,0,0,0,0,0,0,0,0
1,0,0,0,0,0,0,0,0,0,0,0,0,0,0,0,0,0,0,0,0,0,0,0,0
1,0,0,0,0,0,0,0,0,0,0,0,0,0,0,0,0,0,0,0,0,0,0,0,0